WWWWWWWWWWWWWWWW
WCFFFFFFFFFFFFFW
WFFWWWFFFFFFFFFW
WFFFFFWWWWFFFFFW
WFFFWWWWWWWWFFFW
WWFWWWWWWWWWWFFW
WWFWWWWWWWWWFFFW
WWFFFFFWWWWWWWWW
WWWWWWFWWWWWWWWW
WWWWFFFWWWWWWWWW
WFFFFFFFFWWWFFWW
WFFFWFFFFWWFFFFW
WFFWFFFFFWFFFFWW
WFFWFFFFFFFWWWWW
WFFWFFFFFFFFFFBW
WWWWWWWWWWWWWWWW
