WWWWWWWWWWWWWWWW
WFFFFFFFFFFFFFFW
WFFWWWFFFFFFFFFW
WFFFFFWWWWFFFFFW
WFFFWWWWWWWWFFFW
WWFWWWWWWWWWWFFW
WWFWWWWWWWWWFFFW
WWFFFFFWWWWWWWWW
WWWWWWFWWWWWWWWW
WWWWFFFWWWWWWWWW
WFFFFFFFFWWWFFWW
WFFFWFFFFWWFFFFW
WFFWFFFFFWFFFFWW
WFFWFFFFFFFWWWWW
WFFWFFFFFFFFWFFW
WWWWWWWWWWWWWWWW
