WWWWWWWWWWWWWWWWW
WCFFFFFFFFFFFFFFW
WFFWWWFFFFFFFFFFW
WFFFFFWWFWFFFFFFW
WFFFWWWWFWWWFFFFW
WWFWWWWWFFWWWFFFW
WWFWWWWWWWWWFFFFW
WWFFFFFWWWWWWWWFW
WWWWWWFWWWWWWWWwW
WWWWFFFWWWWWWWWFW
WFFFFFFFFWWWFFWFW
WFFFWFFFFWWFFFFFW
WFFWFFFFFWFFFFWFW
WFFWFFFFFFFWWWWFW
WFFWFFFFFFFFFFFFW
WFFFFFFFFFFFFFBFW
WWWWWWWWWWWWWWWWW
